token,aa,polarity,hydropathy,is_stop,is_start
tok_0,,,,,
tok_1,,,,,
tok_2,,,,,
tok_3,,,,,
tok_4,,,,,
tok_5,,,,,
tok_6,,,,,
tok_7,,,,,
tok_8,,,,,
tok_9,,,,,
tok_10,,,,,
tok_11,,,,,
tok_12,,,,,
tok_13,,,,,
tok_14,,,,,
tok_15,,,,,
tok_16,,,,,
tok_17,,,,,
tok_18,,,,,
tok_19,,,,,
tok_20,,,,,
tok_21,,,,,
tok_22,,,,,
tok_23,,,,,
tok_24,,,,,
tok_25,,,,,
tok_26,,,,,
tok_27,,,,,
tok_28,,,,,
tok_29,,,,,
tok_30,,,,,
tok_31,,,,,
tok_32,,,,,
tok_33,,,,,
tok_34,,,,,
tok_35,,,,,
tok_36,,,,,
tok_37,,,,,
tok_38,,,,,
tok_39,,,,,
tok_40,,,,,
tok_41,,,,,
tok_42,,,,,
tok_43,,,,,
tok_44,,,,,
tok_45,,,,,
tok_46,,,,,
tok_47,,,,,
tok_48,,,,,
tok_49,,,,,
tok_50,,,,,
tok_51,,,,,
tok_52,,,,,
tok_53,,,,,
tok_54,,,,,
tok_55,,,,,
tok_56,,,,,
tok_57,,,,,
tok_58,,,,,
tok_59,,,,,
tok_60,,,,,
tok_61,,,,,
tok_62,,,,,
tok_63,,,,,
tok_64,,,,,
tok_65,,,,,
tok_66,,,,,
tok_67,,,,,
tok_68,,,,,
